а=a
о=o
у=u
ы=i
э=e
е=e
ё=o
і=yi
ю=u
я=a
б=b
в=v
г=gh
д=d
дж=dzh
дз=dz
ж=zh
з=z
й=y
к=k
л=l
м=m
н=n
п=p
р=r
с=s
т=t
ў='u
ф=f
х=h
ц=ts
ч=ch
ш=sh
ь=_